111111111111111
101100001000101
100000011E01001
110000001000101
100000001000011
100010001000011
100000100100001
100P00111100011
100001000000001
111111111111111
