111111111111111
1010000010001E1
1001000000C1011
100101000110001
111010001000001
1000010E0100C11
10111C0C0001001
10000C001110101
10000000000P101
111111111111111
