111111111111111
100000010100001
10C0000000E1001
1001001000000C1
10100000C00P001
11C010011000001
110000100011011
100P0010C000001
100000001010001
111111111111111
