1111111111
1100000111
1110000001
1011111001
100101C111
10E0001001
1001000001
100P000001
10000C1001
1111111111
