111111111111111111111111111111111111111111111111111111111111
100000000000000100000100000000000001100110000101010000100001
100000001000110001000110100000111001000011000001000001001001
100000010000000001000001000100011001010000010000000101000001
100001001001000000000000000000000000000100000000101100100001
110010000100000001100001100001001001000000100000000010010001
110000001001000010001000001011000000000000000011000000000001
100000001000000010000010010100000000101000000010011000000001
111000100100000000110000000100000000001000000000001000010001
100010000101001001110000000010000010100010000000000001000001
101010100010000010001000001100100000000100000110001010001001
100100000000000001110011001010001000100000000100000010001011
100000000000010000000011001000011000110000000011000011000001
110001010000101001000001100000000000000000000001000000000001
100100000001000011000000000110101001000000001100000000000001
100100000001000000C01000100001000000000100010000000000100001
100100001001010000001001000000000000000001110100100100101001
111001000000001000000011100101100000001000000010010010001111
100010000000000000100100000001000100000000000000100010011111
100000000110000100001100011000000000000000001100001001001001
100000000000000010100011000100100000001011010111000000001001
1100010101010000000010100000000000010100000C0000010010100101
100100001101000010101010000001000000001100000000010001010011
111000101000000001000011110000000000000000000110110001010111
100110010000101000000100100000000000000000000000100010010101
1011C0111010000000000011000000000110000011100010110000011101
100000001000100000100101000100001000010010000010000000000011
101000001010000000000000100001010001000000001000000000000001
101001000100001000000111000100010100000010001000000010001011
110000000000000000000000000000000110000100010100011010000101
110100010000010001100000000000010011000001000101110000001001
101001010000110001000000101100011011001000000100000101010101
100100001010010000000000010000101001000000000000000000100011
100010100000001000010000010000001000000001000101C00000000011
100000100000001001101000001000100000000000000010000010011101
100100000101000001010001100000000110000011010010000010100001
100100000000000010000101000000000000000010000100001000000101
100110010000000001000000100101000101100000100000000000000101
110001110000001011000000C00001100001000000000000100000100001
110000000000000011110001100001000010000000000010010000000001
101100100000110100001000010000000100100011100101000000000001
100000010000010000000101000100000000000000001000100100000111
100010000100000000000000000000010100000000000000100110000101
110011000000000001010000000010000100001000001101100000000011
110001000111011000P10000000000000100000000000000011E00100111
100100000011000000001000000011000101001100001011001101101001
110000000100000100000001000000001000000010000000000000000101
10000110000110000100000000C000100001001000011000010001000101
101010000101001100000100000010101000000000101000000000000101
101100000100011000100000100001000000100000000000000000000001
100000000001001000111000000000010001010000011001000100101101
101100111000000000000000C00101000100000100000100001000000001
101100000001000001100100000000000000010010000000000100000001
100000011010001001000000100000011000000000001000000000000001
110000000100000101000000000000100010100000000000000111000001
100000101000000000000000000100110100000100000000000000011101
100000010000100100100000001010000010000001100C01000101000101
100000100000001000010000001000000000000000000000000000110001
100000000000000000010000000000100101000001000110010001010001
111111111111111111111111111111111111111111111111111111111111
