11111111111111111111111111111111111
10001000000011000C00000100011000001
101C0000000000100000000000100100111
10010000110000001000C01010000010001
10000011001010100000000100001001011
11000000000000001000000110001000001
11001001010100000000000001000001001
100000010100000000000000E0000010001
10000000000000010000010000000000001
11000000000000010110000101000000001
10000101010000000100010001010010011
10101000000000000000001100001000101
10010100100010001101001000000000111
10001010101010000110011011011000001
1C000010011000000011000010010000101
11000000010100000000000000000P01001
100000000000C0000000010100000000011
100000000110001100C0000000110011001
10001000000010001000000000000100101
10000110000111000000000000011000001
10000000001000000000010010000110011
10000000110010000100001000010000101
10000010000001010000000000100000001
11000000000010110100000010100100011
10000001000011011010001000000000001
10010001010011010011100000010100001
10000100000000000000000000110011001
10000000010001100111010100000010101
10100001000000000001000000001000001
10100010000000000000101000000000101
110001000000000C0010001100000000101
10000000110000000001000100101000001
10000000000000000000100001000101001
10010001001000000010000000000000C01
11111111111111111111111111111111111
